#################
#               #
#               #
#               #
#       G      P 
#               #
#               #
#               #
#               #
#################