############   #############
#            P             #
#                          #
#                          #
#     S                    #
#                          #
#                          #
#                          #
#                          #
############################