###########+++++############
#                          #
#     L                    #
#                          #
             P              
#                          #
#                          #
#                          #
#                          #
############   #############