################# 
#               # 
#               # 
#               # 
 P       T      #    
#               #
#               #
#               #
#               #
#################