################# 
#               # 
#  B            # 
#               # 
 P              #    
#               #
#               #
#               #
#               #
#################