
###################################################################################################
#         ##         ##         ##         ##         ##         ##         ##         ##         #
#   P     ##         ##         ##         ##         ##         ##         ##         ##         #
#     E   ##         ##         ##         ##         ##         ##         ##         ##         #
#         ##         ##         ##         ##         ##         ##         ##         ##         #
###################################################################################################
###########                                                                             ###########
#         #                                                                             #         #
#         #                                                                             #         #
#         #                                                                             #         #
#         #                                                                             #         #
###########                                                                             ###########
###########                                                                             ###########
#         #                                                                             #         #
#         #                                                                             #         #
#         #                                                                             #         #
#         #                                                                             #         #
###########                                                                             ###########
###########                                                                             ###########
#         #                                                                             #         #
#         #                                                                             #         #
#         #                                                                             #         #
#         #                                                                             #         #
###########                                                                             ###########
###########                                                                             ###########
#         #                                                                             #         #
#         #                                                                             #         #
#         #                                                                             #         #
#         #                                                                             #         #
###########                                                                             ###########
###########                                                                             ###########
#         #                                                                             #         #
#         #                                                                             #         #
#         #                                                                             #         #
#         #                                                                             #         #
###########                                                                             ###########
###########                                                                             ###########
#         #                                                                             #         #
#         #                                                                             #         #
#         #                                                                             #         #
#         #                                                                             #         #
###########                                                                             ###########
###########                                                                             ###########
#         #                                                                             #         #
#         #                                                                             #         #
#         #                                                                             #         #
#         #                                                                             #         #
###################################################################################################
#         ##         ##         ##         ##         ##         ##         ##         ##         #
#         ##         ##         ##         ##         ##         ##         ##         ##         #
#         ##         ##         ##         ##         ##         ##         ##         ##         #
#         ##         ##         ##         ##         ##         ##         ##         ##         #
###################################################################################################