###########+++++############
#                          #
#     N                    #
#                          #
             P              
#                          #
#                          #
#                          #
#                          #
############   #############